resources/images/sprites.png
0,0 1,0 2,0 3,0 4,0 0,1 1,1 2,1 3,1 4,1 0,2
0,5 0,5 0,5 0,5 0,5 0,5 0,5 0,5 0,5 0,5 0,5 0,5 0,5 0,5 0,5
0,5 0,5 0,5 0,5 0,5 0,5 0,5 0,5 0,5 0,5 0,5 0,5 0,5 0,5 0,5
0,5 0,5 0,5 0,5 0,5 0,5 0,5 0,5 0,5 0,5 0,5 0,5 0,5 0,5 0,5
1,3 2,2 3,2 1,3 1,3 2,3 3,3