resources/images/sprites.png
0,1 1,1 2,1 3,1 0,1 1,1 2,1 3,1 0,1 1,1 2,1 3,1 0,1 1,1 2,1 3,1 0,1 1,1 2,1 3,1 0,1 1,1 2,1 3,1 0,1 1,1 2,1 3,1 0,1 1,1 2,1 1,2
2,5 2,5 2,5 2,5 2,5 2,5 2,5 2,5 2,5 2,5 2,5 2,5 2,5 2,5 2,5 2,5 2,5 2,5 2,5 2,5 2,5 2,5 2,5 2,5 2,5 2,5 2,5 2,5 2,5 2,5 2,5 2,5
0,5 0,5 0,5 0,5 0,5 0,5 0,5 0,5 0,5 0,5 0,5 0,5 0,5 0,5 0,5 0,5 0,5 0,5 0,5 0,5 0,5 0,5 0,5 0,5 0,5 0,5 0,5 0,5 0,5 0,5 0,5 0,5
0,5 0,5 0,5 0,5 0,5 0,5 0,5 0,5 0,5 0,5 0,5 0,5 0,5 0,5 0,5 0,5 0,5 0,5 0,5 0,5 0,5 0,5 0,5 0,5 0,5 0,5 0,5 0,5 0,5 0,5 0,5 0,5
1,3 2,2 3,2 1,3 1,3 2,3 3,3 1,3 1,3 1,3 1,3 1,3 1,3 3,2 1,3 1,3 1,3 2,2 1,3 1,3 1,3 3,3 1,3 1,3 2,3 1,3 1,3 3,2 1,3 1,3 1,3 1,3
0,6,0450,560 0,6,0482,560 0,6,0514,560
0,6,0546,520 0,6,0578,520 0,6,0610,520
0,6,1050,560 0,6,1082,560 0,6,1114,560
0,6,1146,520 0,6,1178,520 0,6,1210,520
0,6,1900,560
0,6,1946,520 0,6,1978,520 0,6,2010,520

0,6,2780,560
0,6,2876,520